
| **Model Species** | **Definition**                                                                                           | **Explicit or Lumped** | **Molecular Weight** |
| ----------------- | -------------------------------------------------------------------------------------------------------- | ---------------------- | -------------------- |
|AALK1J 	 |Accumulation Mode Alkane Product 1|Aerosol|168 |
|AALK2J 	 |Accumulation Mode Alkane Product 2|Aerosol|168 |
|ABNZ1J 	 |Accumulation Mode Benzene Product 1|Aerosol|144 |
|ABNZ2J 	 |Accumulation Mode Benzene Product 2|Aerosol|144 |
|AISO1J 	 |Accumulation Mode Isoprene Product 1|Aerosol|96 |
|AISO2J 	 |Accumulation Mode Isoprene Product 2|Aerosol|96 |
|AISO3J 	 |Accumulation Mode Isoprene Product 3|Aerosol|168.2 |
|ALKRXN 	 |Precursor of Terpene Aerosol Material|Gas|112 |
|AOLGAJ 	 |Accumulation Mode Oligomerized Anthropogenic Material|Aerosol|176.4 |
|AOLGBJ 	 |Accumulation Mode Oligomerized Biogenic Material|Aerosol|252 |
|APAH1J 	 |Accumulation Mode PAH Product 1|Aerosol|243 |
|APAH2J 	 |Accumulation Mode PAH Product 2|Aerosol|243 |
|APNCOMI	 |non-carbon organic matter (H, O, etc.) attached to POC in aitken mode|Aerosol|220 |
|APNCOMJ	 |non-carbon organic matter (H, O, etc.) attached to POC in accumulation mode|Aerosol|220 |
|APOCI  	 |primary organic carbon in aitken mode|Aerosol|220 |
|APOCJ  	 |primary organic carbon in accumulation mode|Aerosol|220 |
|ASQTJ  	 |Accumulation Mode Sesquiterpene Aerosol|Aerosol|378 |
|ATOL1J 	 |Accumulation Mode Toulene Product 1|Aerosol|168 |
|ATOL2J 	 |Accumulation Mode Toulene Product 2|Aerosol|168 |
|ATRP1J 	 |Accumulation Mode Terpene Product 1|Aerosol|168 |
|ATRP2J 	 |Accumulation Mode Terpene Product 2|Aerosol|168 |
|AXYL1J 	 |Accumulation Mode Xylene Product 1|Aerosol|192 |
|AXYL2J 	 |Accumulation Mode Xylene Product 2|Aerosol|192 |
|BNZHRXN	 |Precursor of Hydro-Benzene Aerosol Material|Gas|127 |
|BNZNRXN	 |Precursor of Nitro-Benzene Aerosol Material|Gas|127 |
|PAHHRXN	 |Precursor of Hydro-Naphthalene Aerosol Material|Gas|187.2 |
|PAHNRXN	 |Precursor of Nitro-Naphthalene Aerosol Material|Gas|187.2 |
|SESQRXN	 |Precursor of Sesquiterpenes Aerosol Material|Gas|204 |
|SULRXN 	 |Precursor of Aerosol Sulfate|Gas|98 |
|TOLHRXN	 |Precursor of Hydro-Toulene Aerosol Material|Gas|141 |
|TOLNRXN	 |Precursor of Nitro-Toulene Aerosol Material|Gas|141 |
|TRPRXN 	 |Precursor of Terpene Aerosol Material|Gas|136 |
|XYLHRXN	 |Precursor of Hydro-Xylene Aerosol Material|Gas|155 |
|XYLNRXN	 |Precursor of Nitro-Xylene Aerosol Material|Gas|155 |
